000101000
010000010
000101000
100000000
000001000
001000000
000001000
100000000
000000100